ympäristö - miljö
ympäristötuho - miljöförstöring
päästö - ett utsläpp
luonnonsuojelu - naturskydd 
kestävä kehitys - hållbar utveckling
ympäristöystävällinen - miljövänlig 
kierrättää - återvinna 
kompostoida - kompostera 
lajitella - sortera 
tuhlata - slösa 
heittää pois - slänga 
ekologinen - ekologisk
hiilidioksidi - koldioxid 
kuivuus - torka
kuolla sukupuuttoon - dö ut
laji - en art 
saastuttaa - förorena 
myrkky - ett gift 
pakokaasu - en avgas 
ongelmajäte - ett problemavfall 
roska - ett skräp 
kierrätys - återvinning 
roskata - skräpa ned 
kierrätyspaperi - returpapper 
ilmaston lämpeneminen - global uppvärmning 
ilmastonmuutos - klimatförändring 
puhdas - ren
likainen - smutsig 
saastunut - förorenad
myrkyllinen - giftig
ympäristöystävällinen - miljövänlig 